level1
..U..rr..U..
..U..rr..U..
..U..rr..U..
..U..rr..U..
............
............
............
............
level2
..U..rr..U..
..U..rr..U..
..U..rr..U..
..U..rr..U..
..U..rr..U..
..R..rr..R..
..U..rr..U..
..R..rr..R..
level3
..U..rr..U..
..U..rr..U..
..U..rr..U..
..U..rr..U..
..U..rr..U..
..R..rr..R..
..U..rr..U..
..R..rr..R..
level4
..U..rr..U..
..U..rr..U..
..U..rr..U..
..U..rr..U..
..U..rr..U..
..R..rr..R..
..U..rr..U..
..R..rr..R..
level5
..U..rr..U..
..U..rr..U..
..U..rr..U..
..U..rr..U..
..U..rr..U..
..R..rr..R..
..U..rr..U..
..R..rr..R..